Loo|vel
kin|op,
g f| de
or |plo
an |y, 
exp|and
ert| ma
 te|nag
am |e n
to |ext
del| ge
ive|ner
r d|ati
oma|on 
in |sof
- l|twa
ed,|re 
 pr|pro
oac|duc
tiv|ts 
e s|tha
olu|t w
tio|ill
ns | dr
? W|ive
e'l| yo
l h|ur 
elp|bus
 yo|ine
u d|ss 
esi|for
gn,|war
 de|d. 