Lo|el
ok|op
in|, 
g |de
fo|pl
r |oy
an|, 
 e|an
xp|d 
er|ma
t |na
te|ge
am| n
 t|ex
o |t 
de|ge
li|ne
ve|ra
r |ti
do|on
ma| s
in|of
 -|tw
 l|ar
ed|e 
, |pr
pr|od
oa|uc
ct|ts
iv| t
e |ha
so|t 
lu|wi
ti|ll
on| d
s |ri
? |ve
We| y
'l|ou
l |r 
he|bu
lp|si
 y|ne
ou|ss
 d| f
es|or
ig|wa
n,|rd
 d|. 
ev|  